@@@@@@@@@@@@@@@@@@@@@@@@@@@@@@@@@@@@@@@@@@@@@@@@@@@
@@@@@@@@@@@@@@@@@@@@@@@@@                         @
@@@@@@@@@@@@@@@@@@@@@@@@@ @ @@@@@@@@@@ @@@@@@@@ @ @
@@@@@@@@@@@@@@@@@@@@@@@@@ @                     @ @
@@@@@@@@@@@@@@@@@@@@@@@@@ @ @@@@@@@@@@ @@@@@@@@ @ @
@@@@@@@@@@@@@@@@@@@@@@@@@ @                     @ @
@@@@@@@@@@@@@@@@@@@@@@@@@ @ @@@@@@@@@@ @@@@@@@@ @ @
@@@@@@@@@@@@@@@@@@@@@@@@@ @                     @ @
@@@@@@@@@@@@@@@@@@@@@@@@@ @ @@@@@@@@@@ @@@@@@@@ @ @
@@@@@@@@@@@@@@@@@@@@@@@@@ @ @@@@@@@@@@ @@@@@@@@ @ @
@@@@@@@@@@@@@@@@@@@@@@@@@                         @
@@@@@@@@@@@@@@@@@@@@@@@@@@@@@@@@@@@@@@@@@@@@@@@@@@@
@@@@@@@@@@@@@@@@@@@@@@@@@@@@@@@@@@@@@@@@@@@@@@@@@@@
@@@@@@@@@@@@@@@@@@@@@@@@@@@@@@@@@@@@@@@@@@@@@@@@@@@
@@@@@@@@@@@@@@@@@@@@@@@@@@@@@@@@@@@@@@@@@@@@@@@@@@@
@@@@@@@@@@@@@@@@@@@@@@@@@@@@@@@@@@@@@@@@@@@@@@@@@@@
@@@@@@@@@@@@@@@@@@@@@@@@@@@@@@@@@@@@@@@@@@@@@@@@@@@
@@@@@@@@@@@@@@@@@@@@@@@@@@@@@@@@@@@@@@@@@@@@@@@@@@@
@@@@@@@@@@@@@@@@@@@@@@@@@@@@@@@@@@@@@@@@@@@@@@@@@@@
@@@@@@@@@@@@@@@@@@@@@@@@@@@@@@@@@@@@@@@@@@@@@@@@@@@
@@@@@@@@@@@@@@@@@@@@@@@@@@@@@@@@@@@@@@@@@@@@@@@@@@@
@@@@@@@@@@@@@@@@@@@@@@@@@@@@@@@@@@@@@@@@@@@@@@@@@@@
@@@@@@@@@@@@@@@@@@@@@@@@@@@@@@@@@@@@@@@@@@@@@@@@@@@
@@@@@@@@@@@@@@@@@@@@@@@@@@@@@@@@@@@@@@@@@@@@@@@@@@@
@@@@@@@@@@@@@@@@@@@@@@@@@@@@@@@@@@@@@@@@@@@@@@@@@@@
