@@@@@@@@@@@@@@@@@@@@@@@@@@@@@@@@@@@@@@@@@@@@@@@@@@@
@               #####                             @
@ @ @@@ @@@ @@@@@@@@@@@ @@@ @ @@@@@@@ @@@ @@@@@ @ @
@ @   @ @ @   @       @ @ @   @     @     @   @ @ @
@ @@@ @ @ @@@#@#@@@@@ @ @ @@@@@ @@@@@@@@@@@@@ @@@ @
@ @ @   @    ###    @ @ @ ##  @       @       @ @ @
@ @ @@@@@ @@@ @@@@@@@ @ @ @ @@@ @@@ @@@ @@@ @ @ @ @
@ @         @ @       @ @ @     @   @   @ @ @   @ @
@ @ @@@@@@@ @@@ @@@@@@@ @@@ @ @@@ @@@ @@@ @ @@@ @ @
@ @ @     @   @   @     @   @   @         @ @ @ @ @
@ @@@ @@@ @@@ @@@ @@@ @@@ @ @@@ @@@@@@@@@@@ @ @ @ @
@ @   @       @ @      A  @ @   @ @       @ @   @ @
@ @ @@@@@@#@@ @ @@@ @@@ @@@ @@@ @ @ @@@@@ @ @ @@@ @
@ @         @ @   @   @   @   @   @ @     @ @ @   @
@ @ @ @ @@@@@ @@@ @@@ @@@@@@@ @@@ @ @@@ @@@ @ @ @ @
@ @ @#@     ##  @   @ @  ###  @   @   @     @ @ @ @
@ @ @#@@@@@@@@@ @ @ @ @ @@#@@@@ @@@@@ @@@@@@@ @ @ @
@ @ @#      @   @ @ @   @     @   @ @       ##@   @
@ @@@@@@@@@ @ @@@ @@@@@@@ @@@@@@@ @ @@@@@ @ @@@@@ @
@ @#      @ @     @     @       @   @   @ @ ##  @ @
@ @ @@@@@ @ @@@@@@@ @ @@@ @@@@@ @@@ @ @ @@@#@@@@@ @
@###@     @         @  ###@## @     @ @   @###### @
@ @@@ @@@@@@@@@@@@@@@@@@@@@#@ @@@@@@@ @@@ @#@@@@@ @
@                     ###### ##              ##   @
@@@@@@@@@@@@@@@@@@@@@@@@@@@@@@@@@@@@@@@@@@@@@@@@@@@
